Participant	Institute	Country	Projects (incomplete)
Egon Willighagen	Maastricht University	The Netherlands	NanoCommons, OpenRiskNet, eNanoMapper, EU-ToxRisk, Open PHACTS
Rob Stierum	TNO	The Netherlands	
Ola Spjuth	Uppsala University	Sweden	
Nina Jealiazkova	IdeaConsult Ltd	Bulgaria	eNanoMapper
Thomas Exner	Douglas Connect	Switserland	NanoCommons, OpenRiskNet
Chris Evelo	Maastricht University	The Netherlands	NanoCommons, OpenRiskNet, eNanoMapper, EU-ToxRisk, Open PHACTS
Haralambos Sarimveis	National Technical University of Athens	Greece	eNanoMapper
Jos Kleinjas	Maastricht University	The Netherlands	diXa, DETECTIVE, NanoCommons, TransQTL, EU-ToxRisk
Danyel Jennen	Maastricht University	The Netherlands	diXa, DETECTIVE, NanoCommons, TransQTL, EU-ToxRisk
Daan Geerke	Vrije Universiteit	The Netherlands	
Iseult Lynch	University of Birmingham	UK	
Cedric Notredame	Centre de Regulació Genòmica	Spain	
Emma Schymanski	University of Luxembourg	Luxembourg	
Roland Grafström	Misvik Biology Ltd	Finland	
Hervé Ménager	Institut Pasteur	France	
Lydie Lane	SIB-Swiss	Switzerland	
Penny Nymark	Karolinska Institutet	Sweden	
Antony Williams	U.S. EPA	US	
Bob van de Water	Leiden University	The Netherlands	EU-ToxRisk
Rabea Gräpel	Leiden University	The Netherlands	EU-ToxRisk
